###############################
#   #       #   #     L       #
# # # ##### # # # ########### #
# #L#     # # # #     #     # #
# ### ### # # # ##### # ### # #
#     #   # #L      # #   # # #
##### # ##### ##### # ### # # #
#   # #   #   #   # #   # # # #
# # ### # # ### # # ### # # # #
# #     # #   # # #   # # #L# #
# ##### # ### # # ### # # ### #
#     # #   # # #   # # #     #
### ### ### # ### # # ### #####
#   #   #   #   # # #   #     #
# ### ### ##### # # ### ### ###
# #   #   #     # #   #   #   #
# # ### # # ##### ### # ### # #
###############################