###############################
#        #                    #
#      #                      #
#         #####               #
#         #  L                #
#          #                  #
#           #                 #
#            #                #
#            #                #
# ############          #     #
#                             #
#                             #
#                             #
#                             #
#                             #
#                             #
#                             #
###############################