################
#              #
#              #
#              #
#      #       #
#      #       #
#      #       #
#      #       #
#              #
#              #
#              #
################