################
#  #  #        #
#  #  #######  #
#  #           #
#  #  #    #   #
#  #  #    #   #
#          #   #
#  ##  #       #
#  ##  #   #   #
#  #####   #   #
#    #     #   #
################