##########
#  #     # 
#  #     # 
#  #   # # 
#  #   # # 
#  #   # # 
#  #   # # 
#  #   # # 
#      # # 
##########