##########
#  #     # 
#  #     # 
#  #   # # 
#  #   # # 
#  #   # # 
#  #   # # 
#LL#   # # 
#LL    # # 
##########